F------------------7
|F----------------7|
||F--------------7||
|||F------------7|||
||||F----------7||||
|||||F--------7|||||
||||||F------7||||||
|||||||F----7|||||||
||||||||F--7||||||||
|||||||||s-J||||||||
||||||||L--J||||||||
|||||||L----J|||||||
||||||L------J||||||
|||||L--------J|||||
||||L----------J||||
|||L------------J|||
||L--------------J||
|L----------------J|
L---------g--------J